R,R,R,R,R,R,R,R,R,R,R,R,R,R,R
R,T,T,T,T,T,T,T,W,T,E,T,T,T,R
R,T,T,T,W,T,T,T,W,T,T,T,T,T,R
R,S,T,W,W,W,T,T,W,T,W,W,W,T,R
R,T,T,T,W,T,T,W,W,T,B,W,T,T,R
R,W,T,T,T,T,T,T,T,T,T,W,T,T,R
R,W,W,T,T,T,T,T,W,T,T,T,T,T,R
R,T,W,W,T,T,T,W,W,W,W,T,T,T,R
R,R,R,R,R,R,R,R,R,R,R,R,R,R,R
