W,W,W,W,W,W,W,W,W,W,W,W,W,W,W
W,W,W,T,W{D},W,W,W,W,W,S,T,W,W,W
W,W,W{RD},W{LR},W{LUD},W,W,W,W,T,T,T,W,W,W
W,W,W{UD},T,T,T,T,W,W,T,T,T,W,W,W
W,W{R},W{LUR},T,T,T,T,T,T,T,T,T,W,W,W
W,W,W,W,T,T,T,T,B,T,T,W,W,W,W
W,W,W,W,W,T,T,W,W,W,W,W,W,W,W
W,W,W,W,W,W,W,W,W,W,W,W,W,W,W
W,W,W,W,W,W,W,W,W,W,W,W,W,W,W
