W,W,W,W,W,W,W,W,W,W,W,W,W,W,W
W,W,W,W,W,W,W,W,W,W,W,W,W,W,W
W,W,W,W,W,W,W,W,W,W,W,W,W,W,W
W,W,W,T,T,S,W,W,W,T,W{LR},T{C},W{LR},T{C},W
W,W,T,T,T,T,W,W,W,T,W,W{UD},W,W,W
W,W,T,T,T,T,E,W,W,T,W,T,T,T,W
W,W,B,T,T,T,T,T,W,T,W,T,W,T,W
W,W,W,T,T,T,T,T,T,T,T,T,W,T,W
W,W,W,W,W,W,W,W,W,W,W,W,W,W,W
