W,W,W,W,W,W,W,W,W,W,W,W,W,W,W
W,W,W,W,W,W,W,W,W,W,W,W,W,T{C},W
W,W,W,W,W,W,W,W,W,W,W,W,W,W{UD},W
W,W,W,W,W,E,W,W,W,T,W{LR},T{C},W{LR},T{C},W
W,W,W,T,T,T,T,W,W,T,W,W{UD},W,W,W
W,W,T,T,T,T,S,T,W,T,W,T,T,T,W
W,W,B,T,T,T,T,T,W,T,W,T,W,T,W
W,W,W,W,T,T,T,T,T,T,T,T,W,T,W
W,W,W,W,W,W,W,W,W,W,W,W,W,W,W
