W,W,W,W,W,W,W,W,W,W,W,W,W,W,W
W,W,W,W,T,W,W,T,T,T,T,T,W,W,W
W,W,W,E,T,T,W,T,T,T,B,T,W,W,W
W,W,W,W,W,S,W,T,T,T,T,T,W,W,W
W,W,W,T{C},W,T,W,W,T,W,W,W,W,W,W
W,W,W,W{UD},W,T,W,T,T,T,W,T{C},W,W,W
W,W,W,T{C},W{LR},T,W{LR},T,T,T,W,W{UD},W,W,W
W,W,W,W,W,T,T,T,T,W{LR},W{LR},T{C},W,W,W
W,W,W,W,W,W,W,W,W,W,W,W,W,W,W
