W,W,W,W,W,W,W,T,W,W,W,W,W,W,W
W,W,W,W,W,W,W,T,W,W,W,W,W,W,W
W,W,W,W,W,W,W,T,W,W,W,W,W,W,W
W,W,W,W,W,W,W,T,W,W,W,W,W,W,W
W,W,W,W,W,W,W,S,T,E,W,W,W,W,W
W,W,W,W,W,W,W,W,W,W,W,W,W,W,W
W,W,W,W,W,W,W,W,W,W,W,W,W,W,W
W,W,W,W,W,W,W,W,W,W,W,W,W,W,W
W,W,W,W,W,W,W,W,W,W,W,W,W,W,W
