R,T,R,T,R,T,R,T,R,T,R,T,R,T,R
R,T,T,T,T,T,T,T,T,T,T,T,T,T,R
R,T,T,T,T,T,T,T,T,T,T,T,T,T,R
R,T,T,T,T,T,T,T,T,T,T,T,T,T,R
R,T,T,T,T,T,T,E,T,S,T,T,T,T,R
R,T,T,T,T,T,T,T,T,T,T,T,T,T,R
R,T,T,T,T,T,T,T,T,T,T,T,T,T,R
R,T,T,T,T,T,T,T,T,T,T,T,T,T,R
R,R,R,R,R,R,R,R,R,R,R,R,R,R,R
