W,W,W,W,W,W,W,W,W,W,W,W,W,W,W
W,W,W,W,W,W,W,W,W,W,W,W,W,W,R
W,W,W,W,W,W,W,W,W,W,W,W,W,T,W
W,W,W,W,T,T,T,T,R{LR},T,T,T,T,T,W
W,W,W,W,T,T,W,S,W,B,W,T,T,W{LR},W{LR}
W,W,W,W,T,T,T,T,T,T,T,T,T,W,R
W,W,W,W,W,W,W,W,W,W,W,W,W,W,W
W,W,W,W,W,W,W,W,W,W,W,W,W,W,W
W,W,W,W,W,W,W,W,W,W,W,W,W,W,W
