W,W,W,W,W,W,W,W,W,W,W,W,W,W,W
W,W,W,W,W,W,W,W,W,R,R,R,R,R,W
R,R,R,R,R,R,R,R,R,R,B,T,T,R,R
R,T,T,T,R,T,T,T,R,T,T,T,T,T,T{K}
R,T,R{LURD},T,T,T,R{LURD},T,T,T,T,R,T,T,T{K}
R,T,T,W,R,W,T,T,R,T,T,T,T,T,T{K}
R,R,T,R,R,R,R,R,R,R,T,T,T,R,R
W,W,T,T,W,W,W,W,W,R,R,R,R,R,W
W,W,W,W,W,W,W,W,W,W,W,W,W,W,W
