W,W,W,W,W,W,W,T,W,W,W,W,W,W,W
W,W,W,W,W,W,W,T,W,W,W,W,W,W,W
W,W,W,W,W,W,W,T,W,W,W,W,W,W,W
W,W,W,W,W,W,W,T,W,W,W,W,W,W,W
T,T,T,T,T,T,T,T,W,W,W,W,W,W,W
W,W,W,W,W,W,W,W,W,W,W,W,W,W,W
W,W,W,W,W,W,W,W,W,W,W,W,W,W,W
W,W,W,W,W,W,W,W,W,W,W,W,W,W,W
W,W,W,W,W,W,W,W,W,W,W,W,W,W,W
