W,W,W,W,W,W,W,W,W,W,W,W,W,W,W
W,W,W,W,W,W,W,W,W,W,W,W,W,W,W
W,W,W,W,W,W,W,W,W,W,W,W,W,W,W
W,W,W,W,W,W,W,W,W,W,W,W,W,W,W
W,W,W,W,W,E,T,S,W,W,W,W,W,W,W
W,W,W,W,W,W,W,T,W,W,W,W,W,W,W
W,W,W,W,W,W,W,T,W,W,W,W,W,W,W
W,W,W,W,W,W,W,T,W,W,W,W,W,W,W
W,W,W,W,W,W,W,T,W,W,W,W,W,W,W
