R,R,R,R,R,R,R,R,R,R,R,R,R,R,R
R,T,T,T,T,R,T,T,R,T,T,T,R,T,R
R,T,T,T,T,R,T,T,T,T,T,T,R,T,R
R,S,R,T,R,R,T,T,R,R,T,R,R,T,R
R,B,T,T,T,T,T,R,R,R,T,R,T,T,R
R,T,R,T,R,R,T,T,R,T,T,R,R,T,R
R,T,T,T,T,R,T,T,T,T,T,T,T,T,R
R,E,T,T,T,R,T,T,R,T,T,R,T,T,R
R,R,R,R,R,R,R,R,R,R,R,R,R,R,R
