R,R,R,T{K},T{K},R,R,R,R,R,T{K},T{K},R,R,R
R,T,T,T,T,T,T,T,T,T,T,T,T,T,R
R,T,T,T,T,T,T,T,T,T,T,T,T,T,R
R,T,T,T,T,T,T,T,T,T,T,T,T,T,R
R,T,T,T,T,T,T,S,T,T,T,T,T,T,R
R,T,T,T,T,T,T,T,T,T,T,T,T,T,R
R,T,T,T,T,T,T,T,T,T,T,T,T,T,R
R,T,T,T,T,T,T,T,T,T,T,T,T,T,R
R,R,R,R,R,R,R,R,R,R,R,R,R,R,R
