R,R,R,R,R,R,R,R,R,R,R,R,R,R,R
R,T,T,T,T,T,T,T,T,T,T,T,T,T,R
R,T,T,T,T,T,T,T,T,T,T,T,T,T,R
R,T,T,T,T,T,T,T,T,T,T,T,T,T,R
R,T,T,T,T,T,T,E,T,T,T,T,T,T,R
R,T,T,T,T,T,T,T,T,T,T,T,T,T,R
R,T,T,T,T,T,T,T,T,T,T,T,T,T,R
R,T,T,T,T,T,T,T,T,T,T,T,T,T,R
R,R,R,R,R,R,T{K},T{K},T{K},R,R,R,R,R,R
